##################################################
A               # #                        #     #
# ############# # # ###################### ##### #
# #           # # # #                    # #   # #
# # ######### # # # # #################### # ### #
# # #       # # # # # #                    # #   #
# # # ##### # # #   ### ################## # # ###
# # # #     # # ###     #                # # # ###
# ### ####### #   # ##### ############## # # # ###
#             ### # # # # #   #   #   ## # # #   #
###### # ####   # # # # # # #   #   #  # # # ### #
#    # # #  # # # # # # # # ############ # #   # #
# #### # # ## # # # # # # #              # ### # #
#      # #    # # # # # # # ############## #   # #
######## ###### # # # # # # #              # ### #
#        #    # # # # # # # # ##############  ## #
# ###### # #### # # # # # # # # #   #          # #
# #    # #        # # # # # # # # # # # ###### # #
# # ## # ########## # # # # # # # # # # ##   # # #
# # #  #                # # # #   #   # ## # # # #
# # #### ######## ##### # # # ############ # # # #
# #      #        #   # # # #              # # # #
# # #### # ######## # # # # ################ ### #
# # #### #        # # # # #                  #   G
# #      ######## # # # # # ######## ######### ###
# # ######  #   # # ### # # ##     #       # #   #
# #      ##   #   #     # # #  ###########   ### #
# ####################### #### #  #   #    ##### #
#                              ##   #   #        #
##################################################
