####################
#                 ##
# ### ######### # ##
#   #         # # ##
### #### #### # # ##
#      # #    # # ##
###### # # ## ### ##
#  # #A# # ## # #  #
# ## ### # ## # ## #
#  #     # ## #    #
## ##### # ## ######
#  #   #    #      #
# ## # # #### #### #
# ## # # G  #    # #
# #  # ###### ## # #
# # ##        ## # #
# #  ### ####### # #
# ##   #       # # #
#  ##### ##### # # #
## #   # ### # # # #
#    # #     # # # #
# ############ # # #
#  #   ####### ### #
##   #             #
####################
