                                                  
A                                                 
          ###         ###      # # ### # #        
        ########    ########   # # # # # # ####   
       #        #  #        #  ### ### # # #  #   
           ##          ##      # # #   # # #  #   
          ####        ####     # # ### # # ####   
         ### ##      ### ##                       
         ######      ######                       
          ####        ####                        
           ##          ##                         
                # #                               
                # #                               
                # #                               
       #        ###         #                     
       #                    #                     
       #                    #                     
       ##                  ##                     
        #                  #                      
        ##                ##                      
         ###             ##              #   #    
           ##############   #   #        #   #    
                    # # #   #   #        #   #    
                    # # #   # # # ### ## # ###   G
                    #   #   # # # # # #  # # #    
                    #####   ##### ### #  # ###    
                                                  
                                                  
                                                  
                                                  
